Correr - Run
Dormir - Sleep
Comer - Eat
Saltar - Jump
Ver - Watch
Jugar - Play
Escuchar - Listen
Escribir - Write
Comprar - Buy
Llamar - Call
Estacionar - Park
Llorar - Cry
Caminar - Walk
Beber - Drink
Programar - Programing
Pesta√±ear - Blink
Nadar - Swim
Hablar - Talk
Cantar - Sing
Bailar - Dance
Viajar - Travel
Respirar - Breathe
Ir - Go
Cortar - Chop
Morder - Bite
Matar - Kill
Leer - Read
Besar - Kiss
Manejar - Drive
Abrazar - Hug
Hacer - Do
Crear - Make
Vestir - Wear
Dar - Give
Tomar - Take
Enviar - Send
Decir - Tell
Encontrar - Find
Abrir - Open
Conseguir - Get
Mentir - Lie
Agradecer - Thank
Limpiar - Clean
Traducir - Translate
Creer - Believe
Odiar - Hate
Invitar - Invite
Contar - Count
Saber - Know
Ser - Be
Imaginar - Imagine
Sonreir - Smile
Preocuparse - Worry
Cocinar - Cook
Sentir - Feel
Amar - Love
Descubrir - Discover
Copiar - Copy
Romper - Break
Visitar - Visit